AD=Andorra
AE=Utd.Arab.Emir.
AF=Afghanistan
AG=Antigua/Barbads
AI=Anguilla
AL=Albania
AM=Armenia
AN=Dutch Antilles
AO=Angola
AQ=Antarctica
AR=Argentina
AS=Samoa,American
AT=Austria
AU=Australia
AW=Aruba
AZ=Aserbaidjan
BA=Bosnia-Herz.
BB=Barbados
BD=Bangladesh
BE=Belgium
BF=Burkina-Faso
BG=Bulgaria
BH=Bharain
BI=Burundi
BJ=Benin
BM=Bermuda
BN=Brunei Dar-es-S
BO=Bolivia
BR=Brazil
BS=Bahamas
BT=Bhutan
BV=Bouvet Island
BW=Botswana
BY=White Russia
BZ=Belize
CA=Canada
CC=Coconut Islands
CF=Central Afr.Rep
CG=Congo
CH=Switzerland
CI=Ivory Coast
CK=Cook Islands
CL=Chile
CM=Cameroon
CN=China
CO=Columbia
CR=Costa Rica
CU=Cuba
CV=Cape Verde Is.
CX=Christmas Islnd
CY=Cyprus
CZ=Tschechien
DE=Germany
DJ=Djibouti
DK=Denmark
DM=Dominica
DO=Dominican Rep.
DZ=Algeria
EC=Ecuador
EE=Estonia
EG=Egypt
ER=Eritrea
ES=Spain
ET=Ethiopia
FI=Finland
FJ=Fiji
FK=Falkland Islnds
FM=Micronesia
FO=Faroe Islands
FR=France
GA=Gabon
GB=Great Britain
GD=Grenada
GE=Georgia
GF=French Guinea
GH=Ghana
GI=Gibraltar
GL=Greenland
GM=Gambia
GN=Guinea
GP=Guadeloupe
GQ=Equatorial Gui.
GR=Greece
GT=Guatemala
GU=Guam
GW=Guinea-Bissau
GY=Guyana
HK=Hong Kong
HM=Heard/McDon.Isl
HN=Honduras
HR=Croatia
HT=Haiti
HU=Hungary
ID=Indonesia
IE=Ireland
IL=Israel
IN=India
IO=Brit.Ind.Oc.Ter
IQ=Iraq
IR=Iran
IS=Iceland
IT=Italy
JM=Jamaica
JO=Jordan
JP=Japan
KE=Kenya
KG=Kirghizstan
KH=Cambodia
KI=Kiribati
KM=Comoro Is.
KN=St.Chr.,Nevis
KP=North Korea
KR=South Korea
KW=Kuwait
KY=Cayman Islands
KZ=Kazakhstan
LA=Laos
LB=Lebanon
LC=St. Lucia
LI=Liechtenstein
LK=Sri Lanka
LR=Liberia
LS=Lesotho
LT=Lithuania
LU=Luxembourg
LV=Latvia
LY=Libya
MA=Morocco
MC=Monaco
MD=Moldavia
MG=Madagascar
MH=Marshall island
MK=Macedonia
ML=Mali
MM=Myanmar
MN=Mongolia
MO=Macau
MP=North Mariana
MQ=Martinique
MR=Mauritania
MS=Montserrat
MT=Malta
MU=Mauritius
MV=Maldives
MW=Malawi
MX=Mexico
MY=Malaysia
MZ=Mozambique
NA=Namibia
NC=New Caledonia
NE=Nigeria
NF=Norfolk Island
NG=Nigeria
NI=Nicaragua
NL=Netherlands
NO=Norway
NP=Nepal
NR=Nauru
NU=Niue
NZ=New Zealand
OM=Oman
PA=Panama
PE=Peru
PF=Fren.Polynesia
PG=Papua Nw Guinea
PH=Philippines
PK=Pakistan
PL=Poland
PM=St.Pier,Miquel.
PN=Pitcairn Islnds
PR=Puerto Rico
PT=Portugal
PW=Palau
PY=Paraguay
QA=Qatar
RE=Reunion
RO=Romania
RU=Russian Fed.
RW=Ruanda
SA=Saudi Arabia
SB=Solomon Islands
SC=Seychelles
SD=Sudan
SE=Sweden
SG=Singapore
SH=St. Helena
SI=Slovenia
SJ=Svalbard
SK=Slowakei
SL=Sierra Leone
SM=San Marino
SN=Senegal
SO=Somalia
SR=Suriname
ST=S.Tome,Principe
SV=El Salvador
SY=Syria
SZ=Swaziland
TC=Turks&amp;Caicos Is
TD=Chad
TG=Togo
TH=Thailand
TJ=Tadjikistan
TK=Tokelau Islands
TM=Turkmenistan
TN=Tunisia
TO=Tonga
TP=East Timor
TR=Turkey
TT=Trinidad,Tobago
TV=Tuvalu
TW=Taiwan
TZ=Tanzania
UA=Ukraine
UG=Uganda
UM=Minor Outl.Ins.
US=United States
UY=Uruguay
UZ=Uzbekistan
VA=Vatikanstadt
VC=St. Vincent
VE=Venzuela
VG=Brit.Virgin Is.
VI=US Virgin Is.
VN=Vietnam
VU=Vanuatu
WF=Wallis,Futuna
WS=Western Samoa
YE=North Yemen
YT=Mayotte
YU=Yugoslavia
ZA=South Africa
ZM=Zambia
ZR=Zaire
ZW=Zimbabwe